###########################################################
#X.2...............................4.....................1#
#.##.............2...........3...............7.......####.#
#.#.........###........................#................#.#
#.#.A.......F.....3.......#####........#................#.#
#.#......4.............................#.......8........#.#
#.###............#...........8..........A.............###.#
#3..........5...............##.........................5..#
#..........................#F#............................#
#....3........B............###.....##1.......C......#.....#
#..................#........#.......................#.....#
#........#####.....##...1.........................###.....#
#............#...........F.............9..................#
#......1.................................................Y#
###########################################################